"filename", "language", "Python", "JSON", "comment", "blank", "total"
"c:\Users\Tristan\Downloads\HyPCAR3\dataGeneration.py", "Python", 529, 0, 100, 140, 769
"c:\Users\Tristan\Downloads\HyPCAR3\oldCode.py", "Python", 363, 0, 70, 89, 522
"c:\Users\Tristan\Downloads\HyPCAR3\oldProcessing.py", "Python", 73, 0, 2, 10, 85
"c:\Users\Tristan\Downloads\HyPCAR3\processing.py", "Python", 45, 0, 1, 21, 67
"c:\Users\Tristan\Downloads\HyPCAR3\pypsg\__init__.py", "Python", 15, 0, 0, 1, 16
"c:\Users\Tristan\Downloads\HyPCAR3\pypsg\cfg\__init__.py", "Python", 30, 0, 0, 2, 32
"c:\Users\Tristan\Downloads\HyPCAR3\pypsg\cfg\base.py", "Python", 1823, 0, 3, 312, 2138
"c:\Users\Tristan\Downloads\HyPCAR3\pypsg\cfg\config.py", "Python", 258, 0, 4, 43, 305
"c:\Users\Tristan\Downloads\HyPCAR3\pypsg\cfg\models.py", "Python", 476, 0, 9, 82, 567
"c:\Users\Tristan\Downloads\HyPCAR3\pypsg\docker.py", "Python", 161, 0, 0, 34, 195
"c:\Users\Tristan\Downloads\HyPCAR3\pypsg\exceptions.py", "Python", 43, 0, 0, 10, 53
"c:\Users\Tristan\Downloads\HyPCAR3\pypsg\globes\__init__.py", "Python", 10, 0, 0, 3, 13
"c:\Users\Tristan\Downloads\HyPCAR3\pypsg\globes\decoder.py", "Python", 388, 0, 0, 45, 433
"c:\Users\Tristan\Downloads\HyPCAR3\pypsg\globes\exocam\__init__.py", "Python", 6, 0, 0, 3, 9
"c:\Users\Tristan\Downloads\HyPCAR3\pypsg\globes\exocam\exocam.py", "Python", 414, 0, 3, 72, 489
"c:\Users\Tristan\Downloads\HyPCAR3\pypsg\globes\exoplasim\__init__.py", "Python", 5, 0, 0, 1, 6
"c:\Users\Tristan\Downloads\HyPCAR3\pypsg\globes\exoplasim\exoplasim.py", "Python", 374, 0, 3, 51, 428
"c:\Users\Tristan\Downloads\HyPCAR3\pypsg\globes\globes.py", "Python", 492, 0, 4, 66, 562
"c:\Users\Tristan\Downloads\HyPCAR3\pypsg\globes\molec.json", "JSON", 0, 86, 0, 1, 87
"c:\Users\Tristan\Downloads\HyPCAR3\pypsg\globes\structure.py", "Python", 621, 0, 1, 155, 777
"c:\Users\Tristan\Downloads\HyPCAR3\pypsg\globes\waccm\__init__.py", "Python", 6, 0, 0, 2, 8
"c:\Users\Tristan\Downloads\HyPCAR3\pypsg\globes\waccm\waccm.py", "Python", 494, 0, 4, 78, 576
"c:\Users\Tristan\Downloads\HyPCAR3\pypsg\lyr\__init__.py", "Python", 6, 0, 0, 2, 8
"c:\Users\Tristan\Downloads\HyPCAR3\pypsg\lyr\lyr.py", "Python", 165, 0, 40, 28, 233
"c:\Users\Tristan\Downloads\HyPCAR3\pypsg\rad\__init__.py", "Python", 6, 0, 0, 2, 8
"c:\Users\Tristan\Downloads\HyPCAR3\pypsg\rad\rad.py", "Python", 63, 0, 33, 16, 112
"c:\Users\Tristan\Downloads\HyPCAR3\pypsg\request.py", "Python", 307, 0, 3, 31, 341
"c:\Users\Tristan\Downloads\HyPCAR3\pypsg\settings.py", "Python", 126, 0, 6, 29, 161
"c:\Users\Tristan\Downloads\HyPCAR3\pypsg\trn\__init__.py", "Python", 6, 0, 0, 2, 8
"c:\Users\Tristan\Downloads\HyPCAR3\pypsg\trn\trn.py", "Python", 63, 0, 0, 13, 76
"c:\Users\Tristan\Downloads\HyPCAR3\pypsg\units.py", "Python", 66, 0, 0, 5, 71
"c:\Users\Tristan\Downloads\HyPCAR3\test.ipynb", "JSON", 0, 135, 0, 1, 136
"c:\Users\Tristan\Downloads\HyPCAR3\test.py", "Python", 18, 0, 1, 2, 21
"Total", "-", 7452, 221, 287, 1352, 9312